#########################################################################################################################################################################################################
#A#...#.........#.........#.......#.#.......#...#...............#.........#.#...#...#.....#...#.......#...#...#...........#.#.......#.......#.#...#...#.......#.#.....#...........#.......#.........#...#
#.#.#.###.#####.#.#####.###.###.###.#.###.###.#####.#.#.#.###.#.#.###.#####.#.#.#.###.###.#.#.#.#.###.###.###.#.#######.#.#.#######.###.#.###.#.#####.#.###.###.###.###.#.###.#.#####.#.###.###.###.###.#
#...#.#.....#...#.#.#.....#.#.#.#.....#...#.........#.#.#...#.#.#.#.#.....#...#...#.....#...#...#...#.#.............#.#.#.......#.#.....#.#.#...#.#.#...#.#.#.#...#...#.#...#.#.......#...#.#.....#.....#
#####.#.###.###.###.#####.###.#.#.###.###.#.#######.#.#####.#.#####.#.###.#.#.###.#.###.#######.#####################.#.###.#####.#.#.#.###.###.#.#.#.###.###.###.###.#.#####.#.#############.#.###.#.###
#.#.#.#.#.#...#.#.#.................#.#.#.#.#.#.....#.#.#...#.#.....#.#.....#.#.......#...#.#.....#.....#...........#...#.....#...#.#.#...........#...#.#.........#.......#.#.#...#.......#...#...#.#.#.#
#.#.#.###.#.#.###.###.###.###.###.###.#.#.#.#.###.#####.#.#.#####.###.###############.#####.###########.#####.#######.#.#.#.###.#####.#######.#####.#.#.#.###.#####.#######.###.#.###.#######.#########.#
#...........#.#.....#.#...#...#.#.#.....#.#.....#...#.....#.......#.#.#...........#.#.#.......#.....#.#.#.#.#.#.....#.#.#.#.......#...#.....#.......#.#.....#.....#.....#.#.#...#.#.#...#...#...#...#...#
###.#.#.###.###.#.#.#########.#.###.###.#####.###########.#####.###.#.#.###########.#.#.#.#####.#.###.#.#.#.#.#####.###.###.#.#####.#.#.###.###.#.###.#####.#####.###.###.#.#.###.#.#.#####.#.#.###.###.#
#.#.#.#.#.#.#...#.#.#.......#.#...#.#...#.#.......#.......#.#.#.....#.#.#.....#...#.....#...#...#.#...#...#.#...#.#...#.#.#.#.......#.#.#...#.#.#...#...#.....#...#.....#...#.#.#.......#...#.#...#.....#
#.#####.#.#.#.#.#########.#.###.#####.###.###.#############.#.#.#####.#.###.###.###.#####.###.#####.#.#.###.#.###.#.###.#.#.###.#######.#.###.###.#.#.###########.#.###.###.#.#.#.###.#####.#.#.#######.#
#.#.....#...#.#.#.....#.#.#.#...............#...#.#.#...#.#...#.............#.....#.....#.....#...#.#.......#.......#.....#.#.#...#.....#.#.#...#.#.#.#.....#.#...#.#.......#...#.#...#.......#.#.......#
#.#########.#.###.#.###.###.###.###.#######.###.#.#.#.###.#.###.###.#######.#####.#.###########.#.#####.#.#.#.#######.###.###.###.#.#####.#.###.#######.#.###.###.#########.#.#####.#######.#.###.#####.#
#.#.....#.....#...#.#.#...#.#.#...#.#...#...#...#.....#.#.........#.#.....#.#.#.....#.......#.#.#...#...#.#.....#.#.#...#...#.....#.#...#...#...#.#.....#.#.#.#.........#.#.#.#.#.#.#.......#.#...#.#...#
#.#####.#####.###.###.###.#.#.#####.#.#####.###.###.###.#.#####.###.#.#####.#.#######.###.#.#.###.#.#.###.#.###.#.#.#.#.#.#####.#####.#.###.#.#.#.#.###.###.#.#########.#.#####.#.#.#.#.#####.###.#.###.#
#.....#.......#...#.#.........#...#.....#.#.......#.....#.....#...#.#.....#...#.......#...#.#...#.#.....#.#.#.....#.#.#.#...#...#.#.#.#.#...#.#.....#...#...#.......#.....#.#.....#...#.#.......#.....#.#
#####.###.#####.###.###.###.#.###.#.###.#.#.#########.#####.#.###.#.###.#.###.#.#######.#.###.###.###.#.#.#####.#.#.###.#####.#.#.#.#.###.#######.#########.#.#.#.###.#####.#.#.#######.#.#####.###.#.#.#
#...#...#...........#.#...#.#...#.#.#.....#.#...#.#.#.#.....#.#.#.#.....#.#.#.#...#...#.#.#.#...#...#.#.#.#...#.#.........#.#.#.#.#.#.........#...#.........#.#.#.#.#.........#.#.#...#.#.#.......#.#.#.#
###.#.#.#.#.###.#.###.#.#########.#.#########.#.#.#.#.#####.#.#.#####.#####.#.#######.#.#.#.#.#############.#######.###.###.#.###.#.###.###.###.###.#####.#.#####.#.#.###.#.#####.#.#########.###.#####.#
#...#.#.#.#...#.#.#.....#.......#...#.....#...#.....#.#.#...#.#.....#.#...........#...#.#.#.#.........#...#.......#.#.......#...#.......#.......#.#.#.....#.....#.#.....#.#.#.#...#...#.#.#...#.........#
#.###.#.###.#####.#.#####.#.#.###.#######.#.###.###.#.#.###.#.###.#.#.#.#########.#.###.#.#.###.#######.###.###.#.#####.#####.#.#.###.#######.###.#.#####.#####.#.#.#######.#.#.###.#.#.#.#.#####.###.#.#
#.#...#.#...#.#.....#.#...#.#.#.....#.#.#.#...#...#.......#.#.#...#...#.........#.#.#...#...#...#.......#.....#.#.#...#.#.#.#.#.....#.......#.....#.#.........#...#...#.........#.#.#...#.#.#...#...#.#.#
#.#.#######.#.#.#.###.#####.###.#####.#.#.#.#####.#####.#.#######.###.#####.###.###.#.#.#######.#.###.###.#####.###.###.#.#.#.###.###########.#.#.#.###.#.#.###.#.#.###.###.#####.#.#.###.#.#.#.###.#.###
#.......#.#...#.#.#...#.....#...#.....#.#.......#.....#.#.#.#.#.#.#.#.#.#.....#...#...#.............#...#.#...#.....#.....#.....#...#.....#...#.#.#.#...#.#...#.#...#...#.#.........#.........#...#.#.#.#
#.#.#.###.#.#.###.###.#.#####.#.#####.#.#####.#.###.#######.#.#.#.#.###.#.###########.#.#.#####.#.###.#.#.#.#.#.#.###.###########.###.###.#######.###.#####.###.#####.###.#.###.#####.#.#######.#.#####.#
#.#.#.......#...#.......#.....#...#...#.#.....#.#.#...#.#.....#...#...#.#...#.#.....#.#.#.#.....#...#.#.#.#.#.#.#.............#.#...#.#...#...........#.#.....#...#.#.#...#.#...#.#...#...#.....#.......#
#######.#.#######.#######.###.###.###.#.#.#.#.###.###.#.#####.#######.#.###.#.###.#####.#.#######.#.#########.#.#######.#.###.#.#######.#####.#.#######.#####.#.###.#.#.#.#.#####.###.###.#.#####.#.###.#
#...#...#.#.#.#...#.#.......#...#.#.......#.#...#...#...........#.......#.....#.#.#.#...#...#.#...#...#...............#.#...#.#.#...#.#...#...#.......#...#...#.....#...#.#.......#...#...#.#.....#.#...#
#.#####.###.#.###.#.#######.#.###.###.#####.#######.#.#######.###.#####.#.#.###.#.#.#.#######.###.#################.#####.#####.#.###.###.###.###########.###.#####.###.#.#.###.#.#.#.#.#.###.#.#######.#
#.......#.#.#.....#.........#.#.#...#.#.#...#...#...#...#.#.#.#.#.....#...#...#...#...#.....#...#.#...#...#...........#.#...#...#.#.#.........#.#.......#.#.....#...#...#.#...#.#.#.#.#.#.#.#.#.#.......#
#########.#.#.###.#######.#.###.#######.#.###.#####.#.###.#.#.#.#.###.#.###.###.#.###.#.#####.#####.###.#.#.#.###.#####.#####.###.#.#.#########.###.#.#.#.#.#####.#.###.#############.#####.#####.#.###.#
#.#.....#.#.#.#.#...#.#...#...#.....#.#.#.#...........#.....#...#...#.#...#.....#.....#.#...#.......#...#.#.#.#.#.........#...#.#...#.#...#.....#.#.#.#.........#.#.#.....#.#.#.....#...#.#...#.#.#...#.#
#.#.#.#.#.#.#.#.###.#.###.###.#####.#.#.###.#####.###.#####.###.#####.#########.###.###.#.#######.#.#####.###.#.###.#.#.#.###.#.###.#.#.#.#.###.#.#.#######.#######.#######.#.#.#.###.#.#.###.#.###.###.#
#.#.#.#.#.#.#...#...#...#.#...#.........#...#.#...#.#.#.#.#.#.#...#...#.....#.....#.#...#.....#...#.#...#...#...#.#.#.#.#.#.....#...#...#.#.#...#.#.#...#.....#.....#...#.#.#...#...#.#.........#.....#.#
#.###.#.#.#.#.#####.#.#####.###.#.###.###.###.#.#.#.#.#.#.#.#.#.#####.#.#########.#####.###.###.###.###.#.###.###.###.#.#####.###.#.#####.#.#.###.###.#.#.#.###.#.#.###.#.#.#.#.###.###############.###.#
#.....#.....#.....#...#.......#.#.#...#.#.#...#.#...#.....#.#.#.#...#.#.....#...#...#.........#...#...........#.#...#.#.....#.....#.......#.#...#...#.#...#...#.#.#.#.......#.#.#.....#.......#.#.#...#.#
#.###.#.#####.#.###.#.###.#########.#.#.#.#.###.#####.#.###.#.###.###.#####.#.#######.#########.###.#.#####.###.###.#####.#########.###.#####.###.#####.#####.###########.###########.#.###.###.#.#.#####
#.#...#.#.#...#...#.#.......#.#.#...#.......#.....#...#.#.......#.#.#.......#...#.............#.#...#.....#...#.........#...#.#.#...#.......#.#.#...#.#.....#.#.......#...............#.#.#.#...#.......#
#.#######.#.#.#######.###.#.#.#.#####.#.#.#.#.###.###########.###.#.#.###.###.#.#.#.###.###.#####.###.###.#######.#####.#.#.#.#.#########.#.#.#.#.###.###.#####.#####.###.#.#.#.#####.#.#.#.###.#####.###
#.#.........#.#.......#...#.....#.....#.#.#.#...#.#.#.....#...#.#...#.#.#.#.#.#.#.#...#...#...#...#...#...#.........#.....#.....#.#.......#...#.........#...........#.#.#.#.#.#...#...#.#.....#.#.#.....#
#.#########.###.###.#####.###########.#.###.###.#.#.#####.###.#.#.#####.###.#.#####.###.#.#.#####.#######.###.#.###.###.#####.###.###########.#.#.###.#######.#.#.#.###.#######.#.#.###.#####.#.#.#####.#
#.....#.#...#.....#...#.#...#.....#...#.#...#...#.....#.#.....#.#.......#...#...#.....#.#.#.#.#.....#.....#...#.#...#.....#.................#.#.#...#.#...#.#.#.#.#.#.#.#.....#.#.#...#.....#.....#...#.#
#.###.#.###.#.#####.#.#.#####.###.###########.#######.#.#####.#.#.#.#.###.#####.#####.#####.#.#.#.#####################.#####.#######.###.###.#.###.#####.#.###.#####.#.#####.###.#.#.#.#.###.#####.#.#.#
#...#...#...#.#...#.#.....#.#...#...........#...#...#...#.....#...#.#...#...........#.#...#.#...#...#.#...#.#.....#.....#...#.#...#.#.#.....#.....#.#.......#.#...#...#.......#...#.#.#.#.#.#.......#.#.#
###.#.#####.###.#####.#.###.###.#########.###.###.#.#.###.#####.#####.###.#####.#.###.###.#####.#.###.#.#.#.###.###.#######.#.#.###.###.###############.#####.#####.###.###.#########.#####.###.#####.#.#
#...#.........#...#.#.#.#.#.............#...#...#.#...#.#...#.......#.....#...#.#...#...#.......#.#.....#...#...#...#.....#.....#.....#.#.....#.#...........#.#...#.#.#.#...#.................#.#.......#
#.#####.#####.#.#.#.###.#.#########.#.#####.#.###.#.#.#.###.###.#.#####.###.#.#.###.#.#######.#.#.###.#####.#.###.#.#.#.#####.###.#.#.#.#.###.#.###.#.#######.###.#.#.###.#.#######.#.###.#####.#.#.#####
#.....#.#...#...#...#.#.....#...#...#...#.....#...#.#.....#.#.#.#.#...#.#...#...#.......#.....#.#.#...#...#...#.#.#.#.#.#.....#...#.#.#...#...#.....#.#.....#.....#.......#...#.....#...#.#...#.#.#.#...#
#####.###.#######.###.#.#.###.#####.#################.#.#.#.#.#.#.###.#####.#####.#####.#.#######.#####.#.#.###.#######.###.###.###.#####.#########.#.#.#.#######.#.###.#.#####.###.#.#######.#####.###.#
#...#...#.#...#.#.....#.#.#.#.#...#.#.#.#.......#.#.#.#.#.#.#...#.....#.........#...#.........#.#...#.#.#...#.#.#.....#.......#...#.#...#.....#...#.#...#.#.....#...#.#.#.........#.#...#.....#.....#.#.#
###.###.#.###.#.###.#####.#.#.#.#.#.#.#.###.#####.#.#.#.#.#.#.#######.#######.#########.#.#####.#.#.#.#####.#.#.#.#####.#.#.#.#.###.###.#.#.###.#####.#######.#.#.#.#.###########.###.###.#.#######.#.#.#
#...#.....#.....#.#.....#.....#.#.#...#.#.......#...#.#.#.......#...#.#.#.....#.....#.#.#.#...#...#.#.#.........#.......#.#.#.....#...#.#.#.......#.....#...#.#.#.#.....#...........#...#.#.....#B#...#.#
#.###.#.###.#.#.#.#######.###.#.#.#.#.#.###.#######.#.###.#########.###.#########.#.#.#.#####.#####.#.#######.#.#####.#########.#.#####.###############.###.###.###.#.#########.#####.###.#.#####.###.#.#
#...#.#...#.#.#.........#.#.#.#.#...#.....#.........#.#...#.#...#.......#...#...#.#.#.#...........#...#.#.....#...#.....#...#...#.#.#.....#.....#.#.#.........#.#...#.......#.#...#.#...#.#.....#.#...#.#
###.#.#####.#########.#####.#.#.#############.#.###########.#.#.#####.#.#.#.###.###.#.###.###########.#.#####.#####.#.#####.#####.#.###.#######.#.#.#######.###.#.###.#.###.#.#.###.#.#####.###.#.###.#.#
#.#.#.....#.........#...#...................#.#.....#.#...#...#.#.....#...#.#.....#.#...#.#...#.#.#.#.#.#.#.........#...#.....#...#.....#...#.#.....#.#.....#...#.#.#.#...#.#.#.....#.#.#...#...#.#...#.#
#.#.###################.#.#####.#.#.#########.###.###.###.###.#######.#######.#####.#.#.#.#.#.#.#.#.#.#.#.#######.#.#######.#.#########.#.###.#.###.#.###.#####.#.#.#####.#.#.#.###.###.#####.#.#.###.#.#
#...#...#.#.....#.#...#...#.#...#.#...#.#.......#.....#.........#.......#...#.#.#.....#.#.#.#...#.#.........#.....#.....#...#.#.#.#.........#.#.#.......#...#.#.....#.#.#.#.#.....#.....#.#.#.#.....#.#.#
#.#####.#.#####.#.#.#####.#.###.#.###.#.#.#.#####.###.#.#############.#.###.#.#.#####.#########.#.###.#.#.#########.#.#####.###.#.#.#.#.#####.#.#####.###.###.#.#####.#.#.#.#####.###.###.#.#####.###.#.#
#.........#.......#.#.#...#.#.#.#.#.....#.#.#.......#.........#.#...#.#.........................#...#.#.#...#.....#.#.#.........#.#.#.#.......#.#...........#...#.#.......#...#.....#.#.....#.......#...#
#.#.###.#########.#.#.#####.#.###.#####.#########.#####.#.###.#.#.#.#.#####.#.#.###.#######.#######.###.#######.###.###.#######.#.###.#####.#######.#.###.#####.#.#######.#.#####.#####.#####.#########.#
#.#.#...#...........#.......#.....#...#.#...#.#.....#...#.#.......#.#...#...#.#.#.....#.#.....#...........#.#.....#...#.#.....#...#.....#.#.#.#...#.#.#.#.......#.#.......#...#...#.#.#.......#...#.#.#.#
#.###.#####.###.#.###.###.#######.#.#.###.#.#.#####.#####.###.#.#####.###.#######.#####.#####.#.#.#.###.###.###.#.###.#.#.###.#######.###.###.###.###.#.#########.#.#####.###.#####.#.###.###.#.###.#.#.#
#.#...#.....#...#...#...#.....#.....#.#...#.#.......#.#.#.#...#.#...#...#.#...#.#.....#...#.....#.#.#.......#...#.#.....#...#.#.....#.....#.....#.....#...#...#.#...#.....#.#...#...#.......#.....#.....#
#.#######.#.#####.###.#######.#####.#######.###.###.#.#.#.#######.#.###.###.###.#.#.#.###.###.###.#######.#.#####.###.#.#.#######.#.#.###.#.###.#.###.#.#####.#.###.#######.#######.#####.###.###.#.#.###
#...#.....#.....#.....#...#.#.#...#.........#.#.#.......#...#.....#.....#...#.....#.#...#.....#.#...#.#...#.......#.#.#...........#.#.#.#.....#...#.#...#.......#...........#.....#.#.....#.#.#.....#.#.#
#.#.###.###.#.#######.#.###.###.#.###.#####.#.#.#######.#.###.#####.###.###.#.###.#######.###.#.###.#.#.#.#.#####.#.#.###.###.#.#.#.###.###.#####.#.#####.#.#######.#.#######.#.###.#.#####.#######.#.#.#
#.#...#.#...#.#.#...#.#.#...#.#.#.........#.......#...#.#.#.#...#.....#.#.....#.....#.#...#.#...#.....#.#.#.#.....#...#.#.#.#.#.#.#.....#.......#.#.......#.#...#...#...#...#.#.......#.....#.....#.#...#
#.#.###.#######.#.#.#.#.###.#.#####.#.###.#####.#####.###.#.#####.###.#.#.#.#.#.#####.#####.#.#####.#.###.###########.#.###.#.###.#.#######.#####.###.#######.###.#.#.#.###.###.#####.#.#########.#####.#
#.#.........#.#.#.#.#.....#.#.......#.#.....#...........#...#...#.#.#.#.#.#.#.#...#...#.#...#.#.....#.#...#.#...#.....#.....#.#...#...........#...#.#.........#...#.#.#.#.#.......#.#...#.........#.#...#
#.#####.###.#.#.###.#.#.#.#.#.#####.#.###.###.#.#.#.#.#.#.#.#.#.###.#.#####.#####.#.###.#.###.#####.#####.#.#.###.###.###.###.#####.#.###.#.#.###.#.#.###########.#.#####.###.#.#.#.#.#######.#####.#.#.#
#...#...#.....#.......#.#.........#.#.#...#...#.#.#.#.#.#.#.#.#.........#.......#.......#.....#.........#.......#...#.......#.#.....#.#...#.#.#.............#.....#...#.......#.#...#...............#.#.#
#########################################################################################################################################################################################################